ça a du sens -> that makes sense
je suis né a Toronto -> i was born in toronto
tant -> so much
une bonne question -> a good question
les gens m'aident -> they loved me 
j'essaie de garder la souplesse par contre -> i try to keep flexibility though
je t'ai compris -> i understood you
je veux voir comment t'écris ça -> i wanna see how you write that
ils profitent de la vie -> they enjoy life
ils font pas vraiment attention sur l'argent -> they don't really care about money
tu me donnera ton choix -> you will give me your choice
tu vas être chercheur -> you wanna be a researcher
tu choisis d'abord -> you choose first 
c'est une très petite île -> its a really small island
au sud de l'Inde -> south of India
quels sont tes buts -> what are your goals
je dormais -> I was sleeping
je kiffe -> i like 
il fait jour en plus -> its daytime too 
ça a l'air bon -> it looks good 
tu as bon goût de la musique -> you have a good taste of music
ça à l'air cool -> that looks cool
pas de soucis -> no problem 
j'en fais plus que toi -> I do more than you 
je suis un étudiant en informatique -> i am a computer science student
c'est ma passion -> this is my passion
les gens qui s'exercent -> people who exercise
les gens qui s'entraînent -> people who train
c'est le mental -> it's the mind
est-ce que tu t'entraînes -> do you train
tout le monde est désespéré -> everyone is desperate
j'étais toute la journée à l'école -> I was at school all day
où as-tu appris à parler français -> where did you learn to speak french
tu veux me raconter -> you want to tell me
je vais essayer de trouver ça -> i will try to find that
c'est difficile même pour les français -> it's difficult even for the French
la plupart des gens utilisent des abrèviations -> most people use abbreviations
j'aime bien de connaître de nouvelle musique -> I like to know new music
je veux venir en france un jour -> I want to come to France one day
je n'ai jamais écouter -> I never listen
c'est un homme très intéressant -> he's a very interesting man
mais il a pleins de talent -> but he's very talented 
ça a du flow -> it has flow 



notes with kim____
je suis impressionné -> I'm impressed
c'est preque impossible de trouver un français -> it's almost impossible to find a french
j'espère que tu te souviendras de ton idée -> I hope you will remember your idea
comment ta journée s'est-elle passé -> how did your day go
comment s'est passé ta journée -> How was your day
quels sont tes autres intérêts? -> what are your other interests
la musculation -> bodybuilding
le basket -> basketball
je travaille sur la perte de gras -> I work on fat loss
ces dernier jours -> these last days
je dors tard -> I sleep late
donc qui sait? -> so who knows?
une heure -> one hour
tu es vif d'espirit -> you are sharp-minded
